@
901030005
000000000
000000000
000000000
000000000
000000000
@
901000100
000000000
000000000
@
901110005
000000000
000000000
001112005
001110305
000000000
000000000
@
904000400
000000000
000000000
@
904040400
000000000
000000000
000000000
000000000
000000000
@
905000500
000000000
000000000
@
950050005
000000000
000000000
@
902020200
000000000
000000000
000000000
@
001030010
@
900000000
001000100
010000010
000000000
000000000
000000000
900060000