@
001030005
000000000
000000000
000000000
000000000
000000000
@
001000100
000000000
000000000
@
001110005
000000000
000000000
001112005
001110305
000000000
000000000
@
004000400
000000000
000000000
@
004040400
000000000
000000000
000000000
000000000
000000000
@
005000500
000000000
000000000
@
050050005
000000000
000000000
@
002020200
000000000
000000000
000000000
@
001030010
@
000000000
001000100
010000010
000000000
000000000
000000000
000060000